0 1 1 1 1 1 1 1 1 1 1 1 1 1 1 2
3 4 4 4 4 4 4 4 4 4 4 4 4 4 4 5
3 4 4 4 4 4 14 16 16 16 16 15 4 4 4 5
3 4 4 4 4 4 18 19 19 19 19 20 4 4 4 5
3 4 4 4 4 4 4 4 4 4 4 4 4 4 4 5
3 4 4 4 4 10 7 7 7 7 7 7 11 4 4 5
3 4 4 4 4 5 9 9 9 9 9 9 3 4 4 5
3 4 4 4 4 5 9 9 9 9 9 9 3 4 4 5
3 4 4 4 4 5 9 9 9 9 9 9 3 4 4 5
3 4 4 4 4 13 1 1 1 1 1 1 12 4 4 5
3 4 4 4 4 4 4 4 4 4 4 4 4 4 4 5
6 7 7 7 7 7 7 7 7 7 7 7 7 7 7 8